111111111111111111111111111111111111111111111111111
100000000000000000000000000000000000000000000000001
100000000000000000000000000000000000000000000000001
100000011001111000111000011111000000011000000000111
100000000000000000000000000000000000000000000000001
100000000000000000000000000000000000000000000000001
100001110000000000001111000011100000010000000010001
100000000000000000000000000000000000000000000000001
100000000000000000000000000000000000000000000000001
100000000000001111000000000000001110000011100000111
100000000000000000000000000000000000000000000000001
100000000000000000000000000000000000000000000000001
100000001110000000000001111000000011000000001111111
100000000000000000000000000000000000000000000000001
100000000000000000000000000000000000000000000000001
100011110001100010000000001111000111000000111000001
111111111111111111111111111111111111111111111111111